000000016F000000016F000000016F000000016F000000016F000000016F000000016F000000016F000000016F000000016F000000016F000000016F000000016F000000016F000000016F000000016F000000016F000000016F000000016F000000016F000000016F000000016F000000016F000000016F000000016F000000016D000000016D000000016D000000016D000000016D000000016D000000016D000000016D000000016D
000000016F000000000000000000000000000000000000000000000000000000000000000000000000000000000000000000000000000000000000000000000000000000000000000000000000000000000000000000000000000000000000000000016F000000000000000000000000000000000000000000000000000000000000000000016D000000000000000000000000000000000000000000000000000000000000000000016D
000000016F000000000000000000000000000000000000000000000000000000000000000000000000000000000000000000000000000000000000000000000000000000000000000000000000000000000000000000000008030000000000000000016F000000000000000000000000002005000000000000000000000000000000000000016D000000000000000000000000000000000000000000000000000000000000000000016D
000000016F000000000000000000000000000000000000000000000000000000000000000000000000000000000000000000000000000000000000000000000000000000000000000000000000000000000000000000000000000000000000000000016F000000000000000000000000000000000000000000000000000000000000000000016D000000000000000000000000000000000000000000000004040000000000000000016D
000000016F000000000000000000000000000000000000000000000000000000000000000000000000000000000000000000000000000000000000000000000000000000000000000000000000000000000000000000000000000000000000000000016F000000000000000000000000000000000000000000000000000000000000000000016D000000000000000000000000000000000000000000000000000000000000000000016D
000000016F000000000000000000000000000000000000000000000000000000000000000000000000000000000000000000000000000000000000000000000000000000000000000000000000000000000000000000000000000000000000000000016F000000000000000000000000000000000000000000000000000000000000000000016D000000000000000000000000000000000000000000000000000000000000000000016D
000000016F00000000000000000000000000000000000000000000000000000000016F000000016F000000016F000000016F000000016F000000016F000000016F000000016F000000016F000000016F000000016F000000016F000000016F000000016F00000000000000000000000000000000000000000000000000000000016D000000016D000000016D00000000000000000000000000000000000000000000000000000000016D
000000016F00000000000000000000000000000000000000000000000000000000023C000000023C000000023C000000023C000000023B000000023B000000023B000000023C000000023B000000023B000000023B000000023B000000023C000000023B0000000000000000016D000000016D000000016D000000016D000000016D000000016D000000016D000000016D000000016D0000008007000000016D000000016D000000016D
000000016F00000000000000000000000000000000000000000000000000000000023C000000023C000000023C000000023B000000023C000000023C000000023C000000023C000000023C000000023B00000001410000000141000000023C000000023B0000000000000000016D000000023B000000023B000000023B000000023B000000023B000000023B000000023B000000023B000000000000000000000000000000000000016D
000000016F000000000000000000000000000000000000000000000000000000000000000000023C000000023C000000023C000000023B000000023B000000023C000000023B000000023C000000023B000002000C000008000D000000023B000000023C0000000000000000016D000000023B000000023B000000023B000000023B000000023B000000023B000000023B000000023B000000000000000000000000000000000000016D
000000016F000000000000000000000000000000000000000000000000000000000000000000023B000000023C000000023C000000023B000000023C000000023C000000023B000000023B000000023C000000023B0000000000000000023C000000023B0000000000000000016D000000023B000000023B000002000C000000000000000000000000000000000000023B000000023B000000000000000000000000000000000000016D
000000016F0000000000000000000000000000000000000000000000000000000000000000000000000000023B000000023B000000023C000000023C000000023B000000023C000000023B000000023C000000023C0000000000000000023C000000023B0000000000000000016D000000023B000000023B000000023B000000023B000000023B0000000000000000023B000000023B000000000000000000000000000000000000016D
000000016F0000000000000000000000000000000000000000000000000000000000000000000000000000023B000000023C000000023C000000023B000000023B000000023C000000023B000000023B000000023B0000000000000000023B000000023C0000000000000000016D000000023B000000023B000000023B000000023B000000023B0000000000000000023B000000023B000000000000000000000000000000000000016D
000000016F00000000000000000000000000000000000000000000000000000000000000000000000000000000000000000000000000000000000000000000000000000000000000000000000000000000000000000000000000000000000000000000000000000000000000000000000000000000000000000000000000000000000000000000000000000000000000000000000000000000000000000000000000000000000000016D
000000016F00000000000000000000000000000000000000000000000000000000000000000000000000000000000000000000000000000000000000000000000000000000000000000000000000000000000000000000000000000000000000000000000000000000000000000000000000000000000000000000000000000000000000000000000000000000000000000000000000000000000000000000000000000000000000016D
000000016F00000000000000000000000000000000000000000000000000000000000000000000000000000000000000000000000000000000000000000000000000000000000000000000000000000000000000000000000000000000000000000000000000000000000000000000000000000000000000000000000000000000000000000000000000000000000000000000000000000000000000000000000000000000000000016D
000000016F00000000000000000000000000000000000000000000000000000000000000000000000000000000000000000000000000000000000000000000000000000000000000000000000000000000000000000000000000000000000000000000000000000000000000000000000000000000000000000000000000000000000000000000000000000000000000000000000000000000000000000000000000000000000000016D
000000016F00000000000000000000000000000000000000000000000000000000000000000000000000000000000000000000000000000000000000000000000000000000000000000000000000000000000000000000000000000000000000000000000000000000000000000000000000000000000000000000000000000000000000000000000000000000000000000000000000000000000000000000000000000000000000016D
000000016F00000000000000000000000000000000000000000000000000000000000000000000000000000000000000000000000000000000000000000000000000000000000000000000000000000000000000000000000000000000000000000000000000000000000000000000000000000000000000000000000000000000000000000000000000000000000000000000000000000000000000000000000000000000000000016D
000000016F00000000000000000000000000000000000000000000000000000000000000000000000000000000000000000000000000000000000000000000000000000000000000000000000000000000000000000000000000000000000000000000000000000000000000000000000000000000000000000000000000000000000000000000000000000000000000000000000000000000000000000000000000000000000000016D
000000016F000000016D000000016D000000016D000000016D000000016D000000016D000000016D000000016D000000016D000000016D000000016D000000016D000000016D000000016D000000016D000000016D000000016D000000016D000000016D000000016D000000016D000000016D000000016D000000016D000000016D000000016D000000016D000000016D000000016D000000016D000000016D000000016D000000016D
