000000016C000000016C000000016C000000016E000000016E000000016E000000016E000000016E000000016E000000016E000000016E000000016E000000016E000000016E000000016E000000016E000000016E000000016E000000016E000000016E000000016E000000016E000000016E000000016E000000016E000000016E000000016E000000016E000000016D000000016D000000016D000000016D000000016C000000016C000000016C000000016C000000016C000000016C000000016C000000016C000000016C000000016C
000000016C000000016C000000016C000000016E000000000000000000000000000000000000000000000000000000000000000000000000000000000000000000000000000000000000000000000000000000000000000000000000000000000000000000000000000000000000000000000000000000000000000000000000000000000000000000000000000008000D00000000000000000000000000023A00000000000000000000000000000000000000000000000000000000016C000000000000000000000000000000000000016F
000000016C000000016C000000016C000000016E00000000000000000000000000000000000000000000000000000000000000000000000000000000000000000000000000000000000000000000000000000000000000000000000000000000000000000000000000000000000000000000000000000000000000000000000000000000000000000000000000000400D800000000000000000000000000023A00000000000000000000000000000000000000000000000000000000016C000000000000000008030000000000000000016F
000000016C000000016C000000016C000000016E000000000000000000000000000000000000023A000000023A000000023A000000023A000000023A000000023A000000023A000000023A000000023A000000023A000000023A000000023A000000023A000000023A000000023A000000023A000000023A000000023A000000023A000000023A000000023A000000016D00000000000000000000000000023A00000000000000000000000000023A00000000000000000000000000016C000000000000000000000000000000000000016F
000000016C000000016C000000016C000000016E000000000000000000000000000000000000000000000000000000000000000000000000000000000000000000000000000000000000000000000000000000000000000000000000000000000000000000000000000000000000000000000000000000000000000000000000000000000000000000000000000000016D00000000000000000000000000023A00000000000000000000000000023A00000000000000000000000000016C000000016C0000000000000000016C000000016F
000000016C000000016C000000016C000000016E000000000000000000000000000000000000000000000000000000000000000000000000000000000000000000000000000000000000000000000000000000000000000000000000000000000000000000000000000000000000000000000000000000000000000000000000000000000000000000000000000000016D00000000000000000000000000023A00000000000000000000000000023A00000000000000000000000000023A000000000000000000000000000000000000016C
000000023A000000023A000000023A000000016E000000023A000000023A000000023A000000023A000000023A000000023A000000023A000000023A000000023A000000023A000000023A000000023A000000023A000000023A000000023A000000023A000000023A000000023A000000023A000000023A000000023A000000000000000000000000000000000000016D00000000000000000000000000023A00000000000000000000000000023A00000000000000000000000000023A000000000000000000000000000000000000016C
000000023A000000000000000000000000000082000000000000000000000000000000000000000000000000000000000000000000000000000000000000000000000000000000000000000000000000000000000000000000000000000000000000000000000000000000000000000000000000000000000000000000000000000000000000000000000000000000016D00000000000000000000000000023A00000000000000000000000000023A00000000000000000000000000023A000000000000000000000000000000000000016C
000000023A000000000000000000000000000082000000000000000000000000000000000000000000000000000000000000000000000000000000000000000000000000000000000000000000000000000000000000000000000000000000000000000000000000000000000000000000000000000000000000000000000000000000000000000000000000000000016D00000000000000000000000000023A00000000000000000000000000023A00000000000000000000000000023A000000000000000000000000000000000000016C
000000023A00000000000000000000000000016E000000000000000000000000000000000000023A000000023A000000023A000000023A000000023A000000023A000000023A000000023A000000023A000000023A000000023A000000023A000000023A000000023A000000023A000000023A000000023A000000023A000000023A000000023A000000023A000000016D00000000000000000000000000023A00000000000000000000000000023A00000000000000000000000000023A000000000000000000000000000000000000016C
000000023A0000000000000002000C000000016E000000000000000000000000000000000000000000000000000000000000000000000000000000000000000000000000000000000000000000000000000000000000000000000000000000000000000000000000000000000000000000000000000000000000000000000000000000000000000000000000000000016D00000000000000000000000000023A00000000000000000000000000023A00000000000000000000000000023A000000000000000000000000000000000000016C
000000023A00000000000000000000000000016E000000000000000000000000000000000000000000000000000000000000000000000000000000000000000000000000000000000000000000000000000000000000000000000000000000000000000000000000000000000000000000000000000000000000000000000000000000000000000000000000000000016D00000000000000000000000000023A00000000000000000000000000023A00000000000000000000000000023A000000000000000000000000000000000000016C
000000023A0000000000000000023A000000016E000000023A000000023A000000023A000000023A000000023A000000023A000000023A000000023A000000023A000000023A000000023A000000023A000000023A000000023A000000023A000000023A000000023A000000023A000000023A000000023A000000023A000000000000000000000000000000000000016D00000000000000000000000000023A00000000000000000000000000023A00000000000000000000000000023A000000000000000000000000000000000000016C
000000023A00000000000000000000000000016E000000000000000000000000000000000000000000000000000000000000000000000000000000000000000000000000000000000000000000000000000000000000000000000000000000000000000000000000000000000000000000000000000000000000000000000000000000000000000000000000000000016D00000000000000000000000000023A00000000000000000000000000023A00000000000000000000000000023A000000000000000000000000000000000000016C
000000023A0000000000000008000D000000016E000000000000000000000000000000000000000000000000000000000000000000000000000000000000000000000000000000000000000000000000000000000000000000000000000000000000000000000000000000000000000000000000000000000000000000000000000000000000000000000000000000016D00000000000000000000000000023A00000000000000000000000000023A00000000000000000000000000023A000000000000000000000000000000000000016C
000000023A00000000000000000000000000016E00000000000000000000000000016E000000016E000000016E000000016E000000016E000000016E000000016E000000016E000000016E000000016E000000016E000000016E000000016E000000016E000000016E000000016E000000016E000000016E000000016E000000016E000000016E000000016E000000016D00000000000000000000000000023A00000000000000000000000000023A00000000000000000000000000023A000000000000000000000000000000000000016C
000000023A000000000000000000000000000082000000000000000000000000000000000000000000000000000000000000000000000000000000000000000000000000000000000000000000000000000000000000000000000000000000000000000000000000000000000000000000000000000000000000000000000000000000000000000000000000000000016D00000000000000000000000000023A00000000000000000000000000023A00000000000000000000000000023A000000000000000000000000000000000000016C
000000023A000000000000000000000000000082000000000000000000000000000000000000000000000000000000000000000000000000000000000000000000000000000000000000000000000000000000000000000000000000000000000000000000000000000000000000000000000000000000000000000000000000000000000000000000000000000000016D00000000000000000000000000023A00000000000000000000000000023A00000000000000000000000000023A000000000000000000000000000000000000016C
000000016C000000016C000000016C000000016D000000016D000000016D000000016D000000016D000000016D000000016D000000016D000000016D000000016D000000016D000000016D000000016D000000016D000000016D000000016D000000016D000000016D000000016D000000016D000000016D000000016D000000016D000000016C0000000000000000016D00000000000000000000000000023A00000000000000000000000000023A00000000000000000000000000023A000000000000000000000000000000000000016C
000000016C000000016C000000016C000000016D000000040400000000000000000000000000000000000000000000000000000000000000000000000000000000000000000000000000000000000000000000000000000000000000000000000000000000000000000000000000000000000000000000000000000000000000000000000000000000000000000000016D00000000000000000000000000000000000000000000000000000000023A000000000000000000000000000000000000000000000000000000000000000000016C
000000016C000000016C000000016C000000016D000000000000000000000000000000000000000000000000000000000000000000000000000000000000000000000000000000000000000000000000000000000000000000000000000000000000000000000000000000000000000000000000000000000000000000000000000000000000000000000000000000016D00000000000000000000000000000000000000000000000000000000023A000000000000000000000000000000000000000000000000000000000000000000016C
000000016C000000016C000000016C000000016D000000016D000000016D000000016D000000016D000000016D000000016D000000016D000000016D000000016D000000016D000000016D000000016D000000016D000000016D000000016D000000016D000000016D000000016D000000016D000000016D000000016D000000016D000000016D000000016D000000016D000000016C000000016C000000016C000000016C000000016C000000016C000000016C000000016C000000016C000000016C000000016C000000016C000000016C
