000000011B000000011B000000011B000000011B000000011B000000011B000000011B000000011C000000011C000000011C000000011C000000011C000000011C000000011C000000011C000000011C000000011C000000011C000000011C000000011C000000011C000000011C000000011C000000011D000000011C000000011D000000011D000000011D000000011D000000011D000000011D000000011D000000011A000000011A000000011A000000011A000000011A
000000011B00000008030000000000000000000000000000000000000000000000000000000000000000000000000000000000000000000000000000000000000000000000000000000000000000000000000000000000000000000000000000000000000000000000000000000000000000000000000000000000000000000000000000000000000000000000000000000000000000000000000000000000000000000000000000000000000000000000000000000000011A
000000011B0000000000000000011B000000011B000000011B000000011B0000000000000000011B000000011B000000011B000000011B0000000000000000011D000000011D000000011D000000011D000000011D000000011D000000011D000000011D000040004D000040004D000040004D000000011D0000000000000000011B000000011B000000011B000000011B000000011B000000011B000000011B0000000000000000011B000000011C000000011C000000011A
000000011B0000000000000000011B000000011B000000023A000000023A0000000000000000023A000000023D000000011B000000011B00000000000000000000000000000000000000000000000000000000000000000000000000000000000040004D0000400050000040004D0000400050000000011D0000000000000000000000000000000000000000000000000000000000000000000000000000011B0000000000000000011B00000000000000000000000000011A
000000011B0000000000000000011B000000023D000000023D000000023A0000000000000000023A000000023A000000023A000000011B0000000000000000011D000000011D000000011D000000011D000000011D000000011D0000000000000000011D0000400050000040004D000040004D00004000500000000000000000011B000000011B000000011B000000011B000000011B0000000000000000011B0000000000000000011B00000000000000000000000000011A
000000011B0000000000000000011B000000023A000000023A000000023D0000000000000000023D000000023A000000023C000000011B000000000000000000000000000000000000000000000000000000000000000000011D0000000000000000011D000040004D0000400050000040004D000000011D000000000000000000000000000000000000023A000000023A000000011B0000000000000000011B0000000000000000011B00000000000000000000000000011A
000000011B0000000000000000011B0000000000000000000000000000000000000000000000000000000000000000000000000000011B0000000000000000011D000000011D000000011D000000011D000000011D000000011D0000000000000000011D000040005000004000500000400050000000011D000000023A000000023A0000000000000000023D000000023A000000011B0000000000000000011B0000000000000000011B00000000000000000000000000011A
000000011B0000000000000000011B000000023D000000023A000000023D000000023A000000023D000000023D0000000000000000011B00000000000000000000000000011D0000000000000000011D000000000000000000000000000000000000011D000040004D000040004D000040004D000000011D000000023A00000000000000000000000000023A000000023A000000011B0000000000000000011B0000000000000000011B00000000000000000000000000011A
000000011B0000000000000000011B000000023A000000023D000000023D000000023A000000023D000000023A0000000000000000011B00000000000000000000000000011D0000000000000000011D0000000000000000011D0000000000000000011D000000000000000000000000002005000000011D000000023A0000000000000000023A000000023A000000023A000000011B0000000000000000011B0000000000000000011B00000000000000000000000000011A
000000011B0000000000000000011B0000000000000000000000000000000000000000000000000000000000000000000000000000011B00000000000000000000000000011D0000000000000000011D0000000000000000011D0000000000000000011D000000011D000000011D000000011D000000011D000000023A0000000000000000000000000000000000000000000000011B0000000000000000011B0000000000000000011B00000000000000000000000000011A
000000011B0000000000000000011B000000000000000000000000000000000000013E000000000000000000000000000000000000011B0000000000000000011D000000011D0000000000000000011D0000000000000000011D0000000000000000011D000000011D000000011D000000011D000000011D000000023A000000023A000000023A000000023A0000000000000000011B0000000000000000011B0000000000000000011B00000000000000000000000000011A
000000011B0000000000000000011B000008000D00000000000000000000000000013F00000000000000000000000002000C000000011B0000000000000000011D000000011D0000000000000000011D0000000000000000011D0000000000000000011D000000011D000000011D000000011D000000011D000000023A000000023A000000023A00000000000000000000000000011B0000000000000000011B0000000000000000011B00000000000000000000000000011A
000000011B0000000000000000011B000000000000000000000000000000000000011E000000000000000000000000000000000000011B0000000000000000011D000000011D0000000000000000011D0000000000000000011D0000000000000000011D000000011D000000011D000000011D000000011D000000023A000000023A000000023A0000000000000000023A000000011B0000000000000000011B000000011B000000011B00000000000000000000000000011A
000000011B0000000000000000011B000000000000000040060000000000000000011F000000000000000000000000000000000000011B0000000000000000011D000000011D0000000000000000011D0000000000000000011D0000000000000000011D000000011D000000011D000000011D000000011D000000011D000000011D000000011D0000000000000000023A000000011B000000000000000000000000008007000000000000000004040000000000000000011A
000000011B0000000000000000011B000000000000000000000000000000000000000000000000000000000000000000000000000100090000000000000000011D000000011D000000000000000000000000000000000000011D0000000000000000011D000000000000000000000000000000000000000000000000000000000000000000011D00000000000000000000000000011B000000011B000000011B000000011B000000011B000000011B0000000000000000011A
000000011B0000000000000000011B000000011B000000011B000000011B000000011B000000011B000000011B000000011B000000011B0000000000000000011D000000011D000000011D000000011D000000011D000000011D0000000000000000011D000000011D000000011D000000011D000000011D000000011D0000000000000000011D000000023A0000000000000000011B000000011B000000011B000000011B000000011B000000011B0000000000000000011A
000000011B0000000000000000000000000000000000000000000000000000000000000000000000000000000000000000000000000000000000000000000000000000000000000000000000000000000000000000000000000000000000000000000000000000000000000000000000000000000000000000000000000000000000000000011D000000000000000000000000000000000000000000000000000000000000000000000000000000000000000000000000011A
000000011B000000011B000000011B000000011B000000011B000000011B000000011B000000011B000000011B000000011B000000011B000000011B000000011B000000011B000000011C000000011C000000011C000000011C000000011C000000011C000000011C000000011C000000011C000000011C000000011C000000011C000000011C000000011C000000011C000000011C000000011C000000011D000000011A000000011A000000011A000000011A000000011A
