000000016C000000016C000000016C000000016C000000016C000000016C000000016C000000016C000000016C000000016C000000016C000000016C000000016C000000016C000000016C000000016C000000016C000000016C000000016C000000016C000000016C000000016C000000016C000000016C000000016C
000000016C00000000000000000000000000000000000000000000000000000000000000000000000000000000000000000000000000000000000000000000000000000000000000000000000000000000000000000000000000000000000000000000000000000000000000000000000000000000000000000000016C
000000016C00000000000000000803000000000000000000000000000000000000000000000000000000000000000000000000000000000000000000000000000000000000000000000000000000000000000000000000000000000000000000000000000000000000000000000000000000000000000000000000016C
000000016C00000000000000000000000000000000000000000000000000000000000000000000000000000000000000000000000000000000000000000000000000000000000000000000000000000000000000000000000000000000000000000000000000000000000000000000000000000000000000000000016C
000000016C00000000000000000000000000000000000000000000000000000000000000000000000000000000000000000000000000000000000000000000000000000000000000000000000000000000000000000000000000000000000000000000000000000000000000000000000000000000000000000000016C
000000016C00000000000000000000000000000000000000000000000000000000000000000000000000000000000000000000000000000000000000000000000000000000000000000000000000000000000000000000000000000000000000000000000000000000000000000000000000000000000000000000016C
000000016C00000000000000000000000000000000000000000000000000000000000000000000000000000000000000000000000000000000000000000000000000000000000000000000000000000000000000000000000000000000000000000000000000000000000000000000000000000000000000000000016C
000000016C000000016C000000016C000000016C000000016C000000016C000000016C000000016C0000008007000000016C000000016C000000016C000000016C000000016C000000016C0000400050000040005000004000500000400050000040004F000040004F000040004F000040004F000040004F000000016C
000000016C0000000000000000000000000000000000000000000000000000000000000000000000000000000000000000000000000000000000000000000000000000000000000000016C000040004F000040004F000040004F000040004F000040004F000040004F000040005100004000510000400051000000016C
000000016C0000000000000000000000000000000000000000000000000000000000000000000000000000000000000000000000000000000000000000000000000000000000000000016C000000000000000000000000000000000000000000000000000000000000000000000000000000000000000000000000016C
000000016C0000000000000000000000000000000000000000000000000000000000000000000000000000000000000000000000000000000000000000000000000000000000000000016C000000000000000000000000000000000000000000000000000000000000000000000000000000000000002005000000016C
000000016C0000000000000000000000000000000000000000000000000000000000000000000000000000000000000000000000000000000000000000000000000000000000000000016C000000016C000000016C000000016C000000016C000000016C000000016C000000016C000000016C000000016C000000016C
000000016C00000000000000000000000000000000000000000000000000000000000000000000000000000000000000000000000000000000000000000000000000000000000000000000000000000000000000000000000000000000000000000000000000000000000000000000000000000000000000000000016C
000000016C00000000000000000000000000000000000000000000000000000000000000000000000000000000000000000000000000000000000000000000000000000000000000000000000000000000000000000000000000000000000000000000000000000000000000000000000000000000000000000000016C
000000016C00000000000000000000000000000000000000000000000000000000000000000000000000000000000000000000000000000000000000000000000000000000000000000000000000000000000000000000000000000000000000000000000000000000000000000000000004040000000000000000016C
000000016C00000000000000000000000000000000000000000000000000000000000000000000000000000000000000000000000000000000000000000000000000000000000000000000000000000000000000000000000000000000000000000000000000000000000000000000000000000000000000000000016C
000000016C00000000000000000000000000000000000000000000000000000000000000000000000000000000000000000000000000000000000000000000000000000000000000000000000000000000000000000000000000000000000000000000000000000000000000000000000000000000000000000000016C
000000016C000000016C000000016C000000016C000000016C000000016C000000016C000000016C000000016C000000016C000000016C000000016C000000016C000000016C000000016C000000016C000000016C000000016C000000016C000000016C000000016C000000016C000000016C000000016C000000016C
