0000000156000000015600000001560000000156000000015600000001560000000155000000015500000001560000000155000000015500000001550000000155000000015500000001550000000155000000015500000001550000000155000000015500000001550000000155000000015500000001550000000155
00000001560000000000000000000000000000000000000000000000000000000001570000000157000000023A000000023A000000023C000000023A000000023C000000023A000000023C000000023A000000023A000000023A000000023A000000023C000000023B000000023A000000023B000000023A0000000155
00000001560000000000000000080300000000000000000000000000000000000001570000000157000000023A000000023C000000023C000000023A000000023C000000023C000000023A000000023A000000023C000000023C000000023C000000023B000000023A000000023A000000023A000000023C0000000155
0000000156000000000000000000000000000000000000000000000000000000000156000000015700000000000000000000000000000000000000000000000000000000000000000000000000000000000000000000000000000000000000000000000000000000000000000000000000000000000000000000000155
0000000156000000000000000000000000000000000000000000000000000000000156000000015600000000000000000000000000000000000000000000000000000000000000000000000000000000000000000000000000000000000000000000000000000000000000000000000000000000000000000000000155
0000000156000000000000000000000000000000000000000000000000000000000156000000015600000000000000000000000000000000000000000000000000000000000000000000000000000000000000000000000000000000000000000000000000000000000000000000000000000000000000000000000155
0000000156000000000000000000000000000000000000000000000000000000000156000000015600000000000000000000000000000000000000000000000000000000000000000000000000000000000000000000000001560000000156000000000000000000000000000000000000000000000000000000000155
0000000156000000000000000000000000000000000000000000000000000000000154000000015400000000000000000000000000000000000000000000000000000000000000000000000000000000000000000000000001560000000156000000000000000000000000000000000000000000000000000000000155
0000000156000000000000000000000000000000000000000000000000000000000157000000015700000000000000000000000000000000000000000000000000000000000000000000000000000000000000000000000001570000000156000000000000000000000000000000000000000000000000000000000155
0000000156000000000000000000000000000000000000000000000000000000000157000000015700000000000000000000000000000000000000000000000000000000000000000000000000000000000000000000000001570000000157000000000000000000000000000000000000000000000000000000000155
0000000156000000000000000000000000000000000000000000000000000000000157000000015700000000000000000000000000000000000000000000000000000000000000000000000000000000000000000000000001570000000157000000000000000000000000000000000000000000000000000000000155
0000000156000000000000000000000000000000000000000000000000000000000000000000000000000000000000000000000000000000000000000000000000000000000000000000000000000000000000000000000001560000000156000000000000000000000000000000000000000000000000000000000155
0000000156000000000000000000000000000000000000000000000000000000000000000000000000000000000000000000000000000000000000000000000000000000000000000000000000000000000000000000000001560000000156000000000000000000000000000000000000000000000000000000000155
0000000156000000000000000000000000000000000000000000000000000000000000000000000000000000000000000000000000000000000000000000000000000000000000000000000000000000000000000000000001560000000156000000000000000000000000000000000000000000000000000000000155
0000000156000000000000000000000000000000000000000000000000000000000000000000000000000000000000000000000000000000000000000000000000000000000000000000000000000000000000000000000001570000000157000000000000000000000000000000000000040400000000000000000155
0000000156000000000000000000000000000000000000000000000000000000000000000000000000000000000000000000000000000000000000000000000000000000000000000000000000000000000000000000000001570000000157000000000000000000000000000000000000000000000000000000000155
0000000156000000000000000000000000000000000000000000000000000000000000000000000000000000000000000000000000000000000000000000000000000000000000000000000000000000000000000000000001570000000157000000000000000000000000000000000000000000000000000000000155
0000000156000000015600000001560000000156000000015600000001560000000156000000015600000001560000000156000000015600000001560000000156000000015600000001560000000156000000015600000001560000000156000000015400000001540000000154000000015400000001540000000155
