001400000014000000140000001400000000000500000000000000000028000000000000
000001000000000000000100000000000000000000000000000000000000000000000000
000000000000000000000000000000000000000000000000000000000000000000000000
000000000000000000000000000000000000000000000000000000000000000000000000
00000000000A0000000A0000000000000000000000000000000000000000000000000000
00140000001400000014000000000006001E000000000000000000000000000000000000
001400000014000000140000000000000000000000000000000A0000000A000000000000
0014000000140000001400000B0000000000000000000000000A0000000A000000000000
0000000000000000000000000000000000000000000000000000000000000000
00000003
00000002
00000000
