001400000014000000000000000000000000000000000000000000000000000000000000
0014000000140000000A0000000A0000000A000000000005000000001F00000000000000
000002000000020000140205001401000014000000000000000000000000000000000000
000A00000000000000140004000001040000000000000000000000000000000000000000
000A0000000000000014000000000000001E000000000000000A0004000A000000000000
000000000000000000000000000000000000000000000000000000000000000000000000
0000020000000000000A000000000000000A010000000000000A0000000A000000000000
00280000000000000000000000000000000A000000000000000A0000001E000000000000
0000000000000000000000000000000000000000000000000000000000000000
00000003
00000003
00000002
