000000016C000000016C000000016D000000016D000000016D000000016D000000016D000000016D000000016D000000016D000000016D000000016D000000016D000000016D000000016D000000016D000000016D000000016D000000016D000000016D000000016D000000016D000000016D000000016D000000016D000000016D000000016D000000016D000000016D000000016D000000016D
000000016C000000016C000000016D000000000000000000000000000000000000000000000000000000000000000000000000000000000000000000000000000000000000000000000000000000000000000000000000000000000000000000000000000000000000000000000000000000000000000000000000000000000000000000000000000000000000000000000000000000000000016D
000000016C000000016C00000002D50000000000000000016D000000016D000000016D000000016D000000016D000000016D000000016D000000016D000000016D000000016D000000016D000000016D000000016D000000016D000000016D000000016D000000016D000000016D000000016D000000016D000000016D000000016D000000016D000000016D000000016D0000000000000000016D
000000016C000000016C00000002D5000000000000000002D700000002D700000002D700000002D700000002D700000002D700000002D700000002D700000002D700000002D700000002D700000002D700000002D700000002D700000002D700000002D700000002D700000002D700000002D700000002D700000002D700000002D700000002D700000002D7000000016D0000000000000000016D
000000016C000000016C00000002D5000000000000000000000000000000000000000000000000000000000000000000000000000000000000000000000000000000000000000000000000000000000000000000000000000000000000000000000000000000000000000000000000000000000000000000000000000000000000000000000000000000000000000002D60000000000000000016D
000000016C000000016C000000016E00000002D400000002D400000002D400000002D400000002D400000002D400000002D400000002D400000002D400000002D400000002D400000002D400000002D400000002D400000002D400000002D400000002D400000002D400000002D400000002D400000002D400000002D400000002D400000002D4000000000000000002D60000000000000000016D
000000016C000000016C000000016E00000002D700000002D700000002D700000002D700000002D700000002D700000002D700000002D700000002D700000002D700000002D700000002D700000002D700000002D700000002D700000002D700000002D700000002D700000002D700000002D700000002D700000002D700000002D700000002D7000000000000000002D60000000000000000016D
000000016C000000016C00000002D5000000000000000000000000000000000000000000000000000000000000000000000000000000000000000000000000000000000000000000000000000000000000000000000000000000000000000000000000000000000000000000000000000000000000000000000000000000000000000000000000000000000000000002D60000000000000000016D
000000016C000000016C00000002D5000000000000000002D400000002D400000002D400000002D400000002D400000002D400000002D400000002D400000002D400000002D400000002D400000002D400000002D400000002D400000002D400000002D400000002D400000002D400000002D400000002D400000002D400000002D400000002D400000002D4000000016E0000000000000000016D
000000016C000000016C00000002D5000000000000000002D700000002D700000002D700000002D700000002D700000002D700000002D700000002D700000002D700000002D700000002D700000002D700000002D700000002D700000002D700000002D700000002D700000002D700000002D700000002D700000002D700000002D700000002D700000002D7000000016E0000000000000000016D
000000016C000000016C00000002D5000000000000000000000000000000000000000000000000000000000000000000000000000000000000000000000000000000000000000000000000000000000000000000000000000000000000000000000000000000000000000000000000000000000000000000000000000000000000000000000000000000000000000100090000000000000000016D
000000016C000000016C000000016E00000002D400000002D400000002D400000002D400000002D400000002D400000002D400000002D400000002D400000002D400000002D400000002D400000002D400000002D400000002D400000002D400000002D400000002D400000002D400000002D400000002D400000002D400000002D400000002D40000000000000000016E0000000000000000016D
000000016C000000016C000000016E000000016E000000016E000000016E000000016E000000016E000000016E000000016E000000016E000000016E000000016E000000016E000000016E000000016E000000016E000000016E000000016E000000016E000000016E000000016E000000016E000000016E000000016E000000016E000000016E0000000000000000016E0000000000000000016D
000000016C0000000000000000006D0000000000000000000000000000000000000000000000000000000000000000000000000000000000000000000000000000000000000000000000000000000000000000000000000000000000000000000000000000000000000000000000000000000000000000000000000000000000000000000000000000000000000000016E0000000000000000016D
000000016C0000000000000000016E0000000000000000016E000000016E000000016E000000016E000000016E000000016E000000016E000000016E000000016E000000016E000000016E000000016E000000016E000000016E000000016E000000016E000000016E000000016E000000016E000000016E000000016E000000016E000000016E000000016E000000016E0000000000000000016D
000000016C000002200C000000016E0000000000000000000000000000000000000000000000000000000000000000000000000000000000000000000000000000000000000000000000000000000000000000000000000000000000000000000000000000000000000000000000000000000000000000000000000000000000000000000000000000000000000000016E0000000000000000016D
000000016C0000004006000000016E000000016E000000016E000000016D000000016D000000016D000000016D000000016D000000016D000000016D000000016D000000016D000000016D000000016D000000016D000000016D000000016D000000016D000000016D000000016D000000016D000000016D000000016D000000016D000000016D0000000000000000016E0000000000000000016D
000000016C000000016C000000016E0000000803000000000000000000000000000000000000000000000000000000000000000000000000000000000000000000000000000000000000000000000000000000000000000000000000000000000000000000000000000000000000000000000000000000000000000000000000000000000000000000000000000000016E0000000404000000016D
000000016E000000016E000000016E000000016E000000016E000000016E000000016E000000016E000000016E000000016E000000016E000000016E000000016E000000016E000000016E000000016E000000016E000000016E000000016E000000016E000000016E000000016E000000016E000000016E000000016E000000016E000000016E000000016E000000016E000000016D000000016D
