000000013200000001320000000132000000013200000001320000000132000000013200000001320000000132000000013200000001320000000132000000013200000001320000000132000000013200000001320000000132000000013200000001320000000132000000013200000001320000000132000000013200000001320000000132000000013200000001320000000132000000013200000001320000000132000000013200000001140000000114000000011400000001140000000114000000011400000001140000000114000000011400000001140000000114000000011400000001140000000114000000012E000000012E000000012E000000012E000000012E000000012E000000012E000000012E000000012E000000012E000000012E000000012E000000012E0000000000000000000000000000000000000000000000000000000000000000000000000000000000000000000000000000000000000000000000000000000000000000000000000000000000000000000000000000000000000000000000
000000013200000001320000000000000000000000000000000000000000000002000C000000023D000000023B000002000C000002000C000002000C000002000C000002000C000002000C000002000C000002000C000002000C000002000C000002000C000002000C000002000C000002000C000002000C000002000C000002000C0000000132000000013200000001320000000132000000013200000001170000000117000000011400000001140000000114000000011400000001140000000114000000011400000001140000000114000000011400000001140000000114000000011400000001140000000114000000012E000000012E000000012E000000012E000000012E000000012E000000012E000000012E000000012E000000012E000000012E000000012E000000012E0000000000000000000000000000000000000000000000000000000000000000000000000000000000000000000000000000000000000000000000000000000000000000000000000000000000000000000000000000000000000000000000
00000001320000000132000000000000000000000000000000000000000000000000000000000000000000023D000002000C000002000C000002000C000002000C000002000C000002000C000002000C000002000C000002000C000002000C000002000C000002000C000002000C000002000C000002000C000002000C000002000C0000000132000000013200000001320000000132000000011700000001170000000117000040023D000040023D000040023D000040023D000040023D000040023D000040023D000040023D000040023D000040023D000040023D000040023D000040023D000040023D000040023D000000012E000000012E000000012E000000012E000000012E000000012E000000012E000000012E000000012E000000012E000000012E000000012E000000012E0000000000000000000000000000000000000000000000000000000000000000000000000000000000000000000000000000000000000000000000000000000000000000000000000000000000000000000000000000000000000000000000
000000013200000001320000000000000000000000000000000000000000000002000C0000000000000000023B000002000C000002000C000002000C000002000C000002000C000002000C000002000C000002000C000002000C000002000C000002000C000002000C000002000C000002000C000002000C000002000C000002000C0000000132000000013200000001320000000132000000011700000001170000000117000040023D000040023D000040023D000040023D000040023D000040023D000040023D000040023D000040023D000040023D000040023D000040023D000040023D000040023D000040023D000000012E000000012E000000012E000000012E000000012E000000012E000000012E000000012E000000012E000000012E000000012E000000012E000000012E0000000000000000000000000000000000000000000000000000000000000000000000000000000000000000000000000000000000000000000000000000000000000000000000000000000000000000000000000000000000000000000000
0000000132000000013200000000000000000000000002000C00000000000000000000000002000C000000023D000002000C000002000C000002000C000002000C000002000C000002000C000002000C000002000C000002000C000002000C000002000C000002000C000002000C000002000C000002000C000002000C000002000C0000000132000000013200000001320000000117000000011700000001170000000117000040023D000040023D000040023D000040023D000040023D000040023D000040023D000040023D000040023D000040023D000040023D000040023D000040023D000040023D000040023D000000012E000000012E000000012E000000012E000000012E000000012E000000012E000000012E000000012E000000022E000000022E000000022E000000012E0000000000000000000000000000000000000000000000000000000000000000000000000000000000000000000000000000000000000000000000000000000000000000000000000000000000000000000000000000000000000000000000
00000001320000000132000001000900000001320000000132000000013200000001320000000132000000013200000001320000000132000000013200000001320000000132000000013200000001320000000132000000013200000001320000000132000000013200000001320000000132000000013200000001320000000132000000013200000001320000000132000000011700000001170000000117000040023D000040023D000040023D000040023D000040023D000040023D000040023D000040023D000040023D000040023D000040023D000040023D000040023D000040023D000040023D000040023D000000012E000000012E000000012E000000012E000000012E000000012E000000012E000000012E000000012E000000022E000000022E000000022E000000012E0000000000000000000000000000000000000000000000000000000000000000000000000000000000000000000000000000000000000000000000000000000000000000000000000000000000000000000000000000000000000000000000
00000001320000000000000000000000000000000000000000000000000000000000000000000000000000000000000000000000000000000000000000000000000000000000000000000000000000000000000000000000000000000000000000000000000000000000000000000000000000000000000000000000000000000000000000000000000000000000000000000000011700000001170000000117000040023D000040023D000040023D000080005800008000580000800058000080005800008000580000800058000080005800008000590000800059000080005900008000590000800059000040023D000000012E00000000580000000058000000005800000000580000000058000000012E000000012E000000012E000000022E000000022E000000022E000000012E0000000000000000000000000000000000000000000000000000000000000000000000000000000000000000000000000000000000000000000000000000000000000000000000000000000000000000000000000000000000000000000000
00000001320000000000000000000000000000000000000000000000000000000000000000000000000000000000000000000000000000000000000000000000000000000000000000000000000000000000000000000000000000000000000000000000000000000000000000000000000000000000000000000000000000000000000000000000000000000000000000000000011700000001170000000117000040023D000040023D000040023D0000800058000040023D000040023D0000800058000040023D000040023D000040023D0000800059000000033D000000033D000000033D0000800059000040023D000000012E0000000058000000012E000000012E000000012E0000000058000000012E000000012E000000012E000000022E000000022E000000022E000000012E000000033D000000033D000000033D000000033D000000033D000000023D000000023D000000023D000000023D000000023D000000023D000000023D000000023D000000023D000000023D000000023D000000023D000000023D000000023D
0000000132000000000000000000000000000000000000000000000000000000000000000000000000000000000000000000000000000000000000000000000000000000000000000000000000000000000000000000000000000000000000000000000000000000000000000000000000000000000000000000000000000000000000000000000000000000000000000000000001170000000117000040023D000040023D000040023D000040023D0000800058000040023D000040023D0000800058000040023D000040023D000040023D0000800059000000033B0000000117000000033D0000800059000040023D000000012E0000000058000000012E000000012E000000012E0000000058000000012E000000012E000000012E000000022E000000022E000000022E000000012E000000033D000000033D000000033D000000033D000000033D000000023D000000023D000000023D000000023D000000023D000000023D000000023D000000023D000000023D000000023D000000023D000000023D0000000404000000023D
0000000132000000000000000000000000000000000000000000000000000000000000000000000000000000000000000000000000000000000000000000000000000000000000000000000000000000000000000000000000000000000000000000000000000000000000000000000000000000000000000000000000000000000000000000000000000000000000000000000001170000000117000040023D000040023D000040023D000040023D0000800058000040023D000040023D0000800058000040023D000040023D000040023D0000800059000000033D000080005900008000590000800059000040023D000000012E0000000058000000012E000000012E000000012E0000000058000000012E000000012E000000012E000000022E000000022E000000022E000000012E000000033D0000800040000080004000008000400000800040000000023D000000023D000000023D000000023D000000023D000000023D000000023D000000023D000000023D000000023D000000023D000000023D000000003E000000023D
0000000132000000000000000000000000000000000000000000000000000000000000000000005200000000520000000052000000005200000000000000000000000000000000000000000000000000000000000000000000000000000000000000000000000000000000000000000000000000000000000000000000000000000000000000000000000000000000000000000001170000000117000040023D000040023D000080005800008000580000800058000040023D000040023D0000800058000040023D000040023D000040023D0000800059000040023D000040023D000040023D0000800059000040023D000000012E0000000058000000012E000000012E000000012E0000000058000000012E000000012E000000012E000000012E000000012E000000012E000000012E000000033D00008000400000800040000080004000008000400000800041000080004100008000410000800041000000023D000000023D000000023D000000023D000000023D000000023D000000023D000000023D000000003E000000023D
0000000132000000000000000000000000000000000000000000000000000000000052000000005200000000520000000052000000005200000000520000000000000000000000000000000000000000000000000000000000000000000000000000000000000000000000000000000000000000000000000000000000000000000000000000000000000000000000011700000001170000000117000040023D000040023D000080005800008000580000800058000040023D000040023D00008000580000800058000040023D000040023D0000800059000040023D000040023D000040023D0000800059000040023D000000012E0000000058000000012E000000012E000000012E0000000058000000002E000000002E000000002E000000002E000000002E000000022E000000012E000000033D00008000400000800040000080004000000000400000000040000000004000000000400000800041000000023D00000000400000000040000080004100008000410000800041000000023D000000023D000000003E000000023D
000000013200000000000000000000000000000000000000000000000052000000005200000000520000000052000000005200000000520000000052000000005200000000000000000000000000000000000000000000000000000000000000000000000000000000000000000000000000000000000000000000000000000000000000000000000000000000000001170000000117000040023D000040023D000040023D000080005800008000580000800058000040023D000040023D000040023D00008000580000800058000040023D0000800059000040023D000040023D000040023D0000800059000040023D000000012E0000000058000000012E000000012E000000012E0000000058000000012E000000012E000000012E000000012E000000012E000000012E000000012E000000033D0000800040000080004000000000400000000040000000023D000000023D00000000400000800041000000023D00000000400000000040000080004100008000410000800041000000023D000000023D000000003E000000023D
00000001320000000000000000000000000000000000000000000000005200000000520000000052000000085100000000520000000052000000005200000000520000000000000000000000000000000000000000000000000000000000000000000000000000000000000000000000000000000000000000000000000000000000000000000000000001170000000117000040023D000040023D000040023D000040023D000040023D000040023D0000800058000040023D000040023D000040023D000040023D0000800058000040023D0000800059000040023D000040023D000040023D0000800059000040023D000000012E0000000058000000012E000000012E000000012E0000000058000000012E000000012E000000012E000000012E000000012E000000012E000000012E000000033D000000033D00008000400000000040000000023D000000023D000000023D00000000400000800041000000023D00000000400000000040000000023D00008000410000800041000000023D000000023D000000003E000000023D
00000001320000000000000000000000000000000000000000000000005200000000520000000052000000005200000000520000000052000000005200000000520000000000000000000000000000000000000000000000000000000000000000000000000000000000000000000000000000000000000000000000000000000000000000011700000001170000000117000040023D000040023D000040023D000040023D000080005800008000580000800058000040023D0000800058000040023D000040023D0000800058000040023D0000800059000040023D000040023D000040023D0000800059000040023D000000012E0000000058000000012E000000012E000000012E000000012E000000012E000000012E000000012E000000012E000000012E000000012E000000012E000000033D000000033D00008000400000000040000000023D0000000040000000004000000000400000800041000000023D00000000400000000040000000023D00008000410000800041000000023D000000023D000000003E000000023D
0000000132000000000000000000000000000000000000000000000000000000000052000000005200000000520000000075000000005200000000520000000052000000000000000000000000000000000000000000000000000000000000000000000000000000000000000000000000000000000000000000000000000000000000000001170000000117000040023D000040023D000040023D000040023D000040023D0000800058000000033B000000033D000040023D00008000580000800058000040023D0000800058000040023D0000800059000040023D000040023D000040023D000080005900000400D8000000005800000000580000000058000000005800000000580000000058000000012E000000012E000000012E000000012E000000012E000000012E000000012E000000033D000000033D00008000400000000040000000023D0000000040000000004000008000410000800041000000023D00000000400000000040000000023D00008000410000800041000000023D000000023D000000003E000000023D
0000000132000000000000000000000000000000000000000000000000000000000052000000005200000000750000000075000000005200000000520000000000000000000000000000000000000000000000000000000000000000000000000000000000000000000000000000000000000000000000000000000000000000000000000001170000000117000040023D000040023D000040023D000040023D000040023D000080005800008000580000800058000040023D000040023D000040023D000040023D00000400D8000040023D0000800059000040023D000040023D000040023D000040023D000040023D000000012E000000012E000000012E000000012E000000012E0000000058000000012E000000012E000000012E000000012E000000012E000000012E000000012E000000033D000000033D00008000400000000040000000023D00000000400000000040000000023D000000023D000000023D00000000400000000040000000023D00000000400000000040000000023D000000023D000000003E000000023D
000000013200000000000000000000000000000000000000000000000000000000000000000000520000000075000000007500000000520000000000000000000000000000000000000000000000000000000000000000000000000000000000000000000000000000000000000000000000000000000000000000000000000001170000000117000040023D000040023D000040023D000040023D000040023D000040023D000040023D000040023D0000800058000040023D000040023D000042000C000042000C000008000D000040023D000000013D000040023D000040023D000040023D000040023D000040023D000000012E000000012E000000012E000000012E000000012E0000000058000000012E000000012E000000012E000000012E000000012E000000012E000000012E000000033D000000033D00008000400000000040000000023D0000000040000000004000000000400000000040000000004000000000400000000040000000023D00000000400000000040000000023D000000023D000000003E000000023D
00000001320000000000000000000000000000000000000000000000000000000000000000000000000000007500000000750000000000000000000000000000000000000000000000000000000000000000000000000000000000000000000000000000000000000000000000000000000000000000000000000001170000000117000040023D000040023D000040023D000040023D000040023D00008000580000800058000080005800008000580000800058000040023D000040023D000040023D000040023D000042000C000040023D000000013D000040023D000040023D000040023D000040023D000040023D000000012E000000012E000000012E000000012E000000012E0000000058000000012E000000012E000000012E000000012E000000012E000000012E000000012E000000033D000000033D00008000400000000040000000023D0000000040000000004000000000400000000040000000004000000000400000000040000000023D00000000400000000040000000023D000000023D000000003E000000023D
00000001320000000000000000000000000000000000000000000000000000000000000000000000000000007500000000750000000000000000000000000000000000000000000000000000000000000000000000000000000000000000000000000000000000000000000000000000000000000000011700000001170000000117000040023D000040023D000040023D000040023D000040023D0000800058000040023D000040023D000040023D000040023D000040023D000040023D000040023D000040023D000040023D000040023D000040023D000040023D000040023D000040023D000040023D000040023D000000012E000000012E000000012E000000012E000000012E0000000058000000012E000000012E000000012E000000012E000000012E000000012E000000012E000000033D0000000040000000004000000000400000000040000000023D000000023D000000023D000000023D000000023D000000023D000000023D000000023D00000000400000000040000000023D000000023D000000003E000000023D
00000001320000000000000000000000000000000000000000000000000000000000000000000000000000007500000000750000000000000000000000000000000000000000000000000000000000000000000000000000000000000000000000000000000000000000000000000000000000000000005B000000005B000000005B000000005B000000005B000000005B000000005B000000005B00000400D8000000005B000000005B000000005B000000005B000000005B000000005B000000005B000000005B000000005B000000005B000000005B000000005B000000005B000000005B000000005B0000008007000000005B000000005B000000005B000000005B000000005B00000400D80000000040000000004000000000400000000040000000004000000000400000000040000000004000000000400000000040000000004000000000400000000131000000023D000000023D000000023D000000023D000000023D000000023D000000023D00000000400000000040000000023D000000023D000000003E000000023D
00000001760000000176000000017600000001760000000176000000017600000001760000000176000000017600000001760000000176000000017600000001760000000176000000017600000001760000000176000000017600000001760000000176000000017600000001760000000176000000017600000001760000000117000000011700000001170000000117000000011700000001170000000117000000011400000001140000000114000000011400000001140000000114000000011400000001140000000114000000011400000001140000000114000000011400000001140000000114000000011400000001130000000113000000011300000001130000000113000000011300000001130000000113000000033D000000033D000000033D000000033D000000033D000000013100000000400000000040000000004000000000400000000131000000023D000000023D000000023D000000000000000000000000000000000000023D00000000400000000040000000023D000000023D000000003E000000023D
00000001760000000176000000017600000001760000000176000000017600000001760000000176000000017600000001760000000176000000017600000001760000000176000000017600000001760000000176000000017600000001760000000176000000017600000001760000000176000000017600000001760000000117000000011700000001130000000113000000011300000001130000000113000000011300000001130000000113000000011300000001130000000113000000011300000001130000000113000000011300000001130000000113000000011300000001130000000113000000011300000001130000000113000000011300000001130000000113000000011300000001130000000113000000033D000000033D000000033D000000033D000000033D000000013100000000400000000040000000004000000000400000000131000000023D000000023D000000023D00000400D800000040060000000000000000000000000000400000000040000000023D000000023D000000003E000000023D
0000000176000000017600000001760000000176000000017600000001760000000176000000017600000001760000000176000000017600000001760000000176000000017600000001760000000176000000017600000001760000000176000000017600000001760000000176000000010C000000017600000001760000000117000000011700000001130000000113000000011300000001130000000113000000011300000001130000000113000000011300000001130000000113000000011300000001130000000113000000011300000001130000000113000000011300000001130000000113000000011300000001130000000113000000011300000001130000000113000000011300000001130000000113000000033D000000033D000000033D000000033D000000033D000000013100000001310000000131000000013100000001310000000131000000023D000000023D000000023D000000000000000000000000000000000000023D00000000400000000040000040003F000000003E000000003E000000023D
00000001760000000176000000017600000001760000000176000000017600000001760000000176000000017600000001760000000176000000017600000001760000000176000000017600000001760000000176000000017600000001760000000176000000017600000001760000000176000000017600000001760000000117000000011700000001130000000113000000011300000001130000000113000000011300000001130000000113000000011300000001130000000113000000011300000001130000000113000000011300000001130000000113000000011300000001130000000113000000011300000001130000000113000000011300000001130000000113000000011300000001130000000113000000013A000000013A000000013A000000013A000000013A000000013100000001310000000131000000013100000001310000000131000000013A000000013A000000013A000000013A000000013A000000013A000000013A00000001300000000130000000013A000000013A000000013A000000013A
